000000000110011100000000000000000000000
000000001111111110000000100010000000000
000000011111111100011000000010000000000
000001111101111100000000100011000000000
000001111100111100000001011111110100000
011111111110111000001101111111111111110
011111111010010000011111111111111111100
010011111011000001011111111111111001000
000001111110000000111111111111111000000
000001111100000001011111111111100100000
000000110100000001111111111111100000000
000000001100000011111111001011000000000
000000000011100000011110000011110000000
000000000011110000011110000000011100000
000000000001100000001100000000111100000
000000000011000000000000000000000100100
000000000010000000000000000000000000100
000000000000000000000000000000000000000
000000000000100011111111111111100000000